 ┏━━━━━┱─────┬─────┬─────┐
 ┃     ┃ ⊸   │ ⊗   │ &   │
 ┃     ┃ ⅋   │ ⊗   │ &   │
 ┡━━━━━╃─────┼─────┼─────┤
 │ ^   │ ?   │ !   │ ⊕   │
 │ ^   │ ?   │ !   │ ⊕   │
 ├─────┼─────┼─────┤     │
 │ A   │ B   │ C   │     │
 │ A   │ (   │ )   │     │
 ├─────┼─────┼─────╆━━━━━┪
 │ D   │ E   │ F   ┃     ┃
 │ 1   │ ⊥   │ ⊤   ┃Enter┃
 ├─────┴─────┼─────┨     ┃
 │ 0         │ ⊢   ┃  ↲  ┃
 │ 0         │ ,   ┃     ┃
 └───────────┴─────┺━━━━━┛
